"filename", "language", "C++", "Markdown", "JSON", "Makefile", "comment", "blank", "total"
"/home/plato/mipt_projs/course2/geometry_simulator/build/makefile", "Makefile", 0, 0, 0, -22, 0, -10, -32
"/home/plato/mipt_projs/course2/geometry_simulator/src/.VSCodeCounter/2022-09-24_05-55-46/details.md", "Markdown", 0, 26, 0, 0, 0, 6, 32
"/home/plato/mipt_projs/course2/geometry_simulator/src/.VSCodeCounter/2022-09-24_05-55-46/diff-details.md", "Markdown", 0, 15, 0, 0, 0, 6, 21
"/home/plato/mipt_projs/course2/geometry_simulator/src/.VSCodeCounter/2022-09-24_05-55-46/diff.md", "Markdown", 0, 15, 0, 0, 0, 7, 22
"/home/plato/mipt_projs/course2/geometry_simulator/src/.VSCodeCounter/2022-09-24_05-55-46/results.json", "JSON", 0, 0, 1, 0, 0, 0, 1
"/home/plato/mipt_projs/course2/geometry_simulator/src/.VSCodeCounter/2022-09-24_05-55-46/results.md", "Markdown", 0, 16, 0, 0, 0, 7, 23
"/home/plato/mipt_projs/course2/geometry_simulator/src/.VSCodeCounter/2022-09-26_05-00-54/details.md", "Markdown", 0, 27, 0, 0, 0, 6, 33
"/home/plato/mipt_projs/course2/geometry_simulator/src/.VSCodeCounter/2022-09-26_05-00-54/diff-details.md", "Markdown", 0, 15, 0, 0, 0, 6, 21
"/home/plato/mipt_projs/course2/geometry_simulator/src/.VSCodeCounter/2022-09-26_05-00-54/diff.md", "Markdown", 0, 15, 0, 0, 0, 7, 22
"/home/plato/mipt_projs/course2/geometry_simulator/src/.VSCodeCounter/2022-09-26_05-00-54/results.json", "JSON", 0, 0, 1, 0, 0, 0, 1
"/home/plato/mipt_projs/course2/geometry_simulator/src/.VSCodeCounter/2022-09-26_05-00-54/results.md", "Markdown", 0, 16, 0, 0, 0, 7, 23
"/home/plato/mipt_projs/course2/geometry_simulator/src/.VSCodeCounter/2022-09-26_06-49-18/details.md", "Markdown", 0, 27, 0, 0, 0, 6, 33
"/home/plato/mipt_projs/course2/geometry_simulator/src/.VSCodeCounter/2022-09-26_06-49-18/diff-details.md", "Markdown", 0, 11, 0, 0, 0, 6, 17
"/home/plato/mipt_projs/course2/geometry_simulator/src/.VSCodeCounter/2022-09-26_06-49-18/diff.md", "Markdown", 0, 14, 0, 0, 0, 7, 21
"/home/plato/mipt_projs/course2/geometry_simulator/src/.VSCodeCounter/2022-09-26_06-49-18/results.json", "JSON", 0, 0, 1, 0, 0, 0, 1
"/home/plato/mipt_projs/course2/geometry_simulator/src/.VSCodeCounter/2022-09-26_06-49-18/results.md", "Markdown", 0, 16, 0, 0, 0, 7, 23
"/home/plato/mipt_projs/course2/geometry_simulator/src/.VSCodeCounter/2022-09-28_03-32-19/details.md", "Markdown", 0, 27, 0, 0, 0, 6, 33
"/home/plato/mipt_projs/course2/geometry_simulator/src/.VSCodeCounter/2022-09-28_03-32-19/diff-details.md", "Markdown", 0, 26, 0, 0, 0, 6, 32
"/home/plato/mipt_projs/course2/geometry_simulator/src/.VSCodeCounter/2022-09-28_03-32-19/diff.md", "Markdown", 0, 17, 0, 0, 0, 7, 24
"/home/plato/mipt_projs/course2/geometry_simulator/src/.VSCodeCounter/2022-09-28_03-32-19/results.json", "JSON", 0, 0, 1, 0, 0, 0, 1
"/home/plato/mipt_projs/course2/geometry_simulator/src/.VSCodeCounter/2022-09-28_03-32-19/results.md", "Markdown", 0, 17, 0, 0, 0, 7, 24
"/home/plato/mipt_projs/course2/geometry_simulator/src/.VSCodeCounter/2022-10-10_07-38-55/details.md", "Markdown", 0, 31, 0, 0, 0, 6, 37
"/home/plato/mipt_projs/course2/geometry_simulator/src/.VSCodeCounter/2022-10-10_07-38-55/diff-details.md", "Markdown", 0, 49, 0, 0, 0, 6, 55
"/home/plato/mipt_projs/course2/geometry_simulator/src/.VSCodeCounter/2022-10-10_07-38-55/diff.md", "Markdown", 0, 24, 0, 0, 0, 7, 31
"/home/plato/mipt_projs/course2/geometry_simulator/src/.VSCodeCounter/2022-10-10_07-38-55/results.json", "JSON", 0, 0, 1, 0, 0, 0, 1
"/home/plato/mipt_projs/course2/geometry_simulator/src/.VSCodeCounter/2022-10-10_07-38-55/results.md", "Markdown", 0, 17, 0, 0, 0, 7, 24
"/home/plato/mipt_projs/course2/geometry_simulator/src/Button.cpp", "C++", -31, 0, 0, 0, -4, -14, -49
"/home/plato/mipt_projs/course2/geometry_simulator/src/CoordinateSys.cpp", "C++", -59, 0, 0, 0, -9, -32, -100
"/home/plato/mipt_projs/course2/geometry_simulator/src/GeometryObjects.h", "C++", 103, 0, 0, 0, 3, 43, 149
"/home/plato/mipt_projs/course2/geometry_simulator/src/GraphicalPrimitives.h", "C++", 15, 0, 0, 0, 1, 5, 21
"/home/plato/mipt_projs/course2/geometry_simulator/src/Raytracer.h", "C++", 20, 0, 0, 0, 1, 10, 31
"/home/plato/mipt_projs/course2/geometry_simulator/src/Vector.cpp", "C++", -101, 0, 0, 0, -31, -55, -187
"/home/plato/mipt_projs/course2/geometry_simulator/src/Vector3D.cpp", "C++", -44, 0, 0, 0, -9, -17, -70
"/home/plato/mipt_projs/course2/geometry_simulator/src/Vector3D.h", "C++", -22, 0, 0, 0, 0, -12, -34
"/home/plato/mipt_projs/course2/geometry_simulator/src/drawable_objects.h", "C++", -66, 0, 0, 0, -3, -29, -98
"/home/plato/mipt_projs/course2/geometry_simulator/src/geom_primitives/Plane.cpp", "C++", 40, 0, 0, 0, 7, 21, 68
"/home/plato/mipt_projs/course2/geometry_simulator/src/geom_primitives/Sphere.cpp", "C++", 59, 0, 0, 0, 5, 24, 88
"/home/plato/mipt_projs/course2/geometry_simulator/src/geom_primitives/Vector.cpp", "C++", 87, 0, 0, 0, 16, 45, 148
"/home/plato/mipt_projs/course2/geometry_simulator/src/geom_primitives/Vector3D.cpp", "C++", 91, 0, 0, 0, 19, 44, 154
"/home/plato/mipt_projs/course2/geometry_simulator/src/gui.cpp", "C++", -11, 0, 0, 0, -1, -6, -18
"/home/plato/mipt_projs/course2/geometry_simulator/src/gui.h", "C++", -20, 0, 0, 0, 0, -10, -30
"/home/plato/mipt_projs/course2/geometry_simulator/src/gui/AbstractButton.h", "C++", 25, 0, 0, 0, 1, 7, 33
"/home/plato/mipt_projs/course2/geometry_simulator/src/gui/Application.h", "C++", 31, 0, 0, 0, 1, 11, 43
"/home/plato/mipt_projs/course2/geometry_simulator/src/gui/CircleButton.h", "C++", 0, 0, 0, 0, 0, 1, 1
"/home/plato/mipt_projs/course2/geometry_simulator/src/gui/Color.cpp", "C++", 61, 0, 0, 0, 8, 28, 97
"/home/plato/mipt_projs/course2/geometry_simulator/src/gui/Color.h", "C++", 31, 0, 0, 0, 1, 11, 43
"/home/plato/mipt_projs/course2/geometry_simulator/src/gui/ContainerWidget.h", "C++", 27, 0, 0, 0, 3, 11, 41
"/home/plato/mipt_projs/course2/geometry_simulator/src/gui/CoordinateSus.h", "C++", 35, 0, 0, 0, 1, 16, 52
"/home/plato/mipt_projs/course2/geometry_simulator/src/gui/CoordinateSys.cpp", "C++", 50, 0, 0, 0, 7, 23, 80
"/home/plato/mipt_projs/course2/geometry_simulator/src/gui/Event.h", "C++", 50, 0, 0, 0, 1, 9, 60
"/home/plato/mipt_projs/course2/geometry_simulator/src/gui/GraphicSpaceKernelAbstract.h", "C++", 23, 0, 0, 0, 1, 7, 31
"/home/plato/mipt_projs/course2/geometry_simulator/src/gui/Image.h", "C++", 15, 0, 0, 0, 2, 8, 25
"/home/plato/mipt_projs/course2/geometry_simulator/src/gui/Matrix.h", "C++", 52, 0, 0, 0, 1, 24, 77
"/home/plato/mipt_projs/course2/geometry_simulator/src/gui/Pixel.h", "C++", 15, 0, 0, 0, 0, 7, 22
"/home/plato/mipt_projs/course2/geometry_simulator/src/gui/RectButton.h", "C++", 30, 0, 0, 0, 1, 8, 39
"/home/plato/mipt_projs/course2/geometry_simulator/src/gui/Text.cpp", "C++", 7, 0, 0, 0, 1, 4, 12
"/home/plato/mipt_projs/course2/geometry_simulator/src/gui/Text.h", "C++", 14, 0, 0, 0, 1, 6, 21
"/home/plato/mipt_projs/course2/geometry_simulator/src/gui/Texture.cpp", "C++", 84, 0, 0, 0, 11, 45, 140
"/home/plato/mipt_projs/course2/geometry_simulator/src/gui/Texture.h", "C++", 35, 0, 0, 0, 1, 17, 53
"/home/plato/mipt_projs/course2/geometry_simulator/src/gui/Widget.h", "C++", 21, 0, 0, 0, 3, 10, 34
"/home/plato/mipt_projs/course2/geometry_simulator/src/gui/Window.h", "C++", 31, 0, 0, 0, 0, 7, 38
"/home/plato/mipt_projs/course2/geometry_simulator/src/gui/glib_wrapper.h", "C++", 91, 0, 0, 0, 30, 26, 147
"/home/plato/mipt_projs/course2/geometry_simulator/src/logger.cpp", "C++", 161, 0, 0, 0, 19, 88, 268
"/home/plato/mipt_projs/course2/geometry_simulator/src/logger.h", "C++", 68, 0, 0, 0, 19, 24, 111
"/home/plato/mipt_projs/course2/geometry_simulator/src/main.cpp", "C++", 1, 0, 0, 0, -4, 0, -3
"/home/plato/mipt_projs/course2/geometry_simulator/src/raytracing/RaytracingTest.cpp", "C++", 217, 0, 0, 0, 21, 84, 322
"/home/plato/mipt_projs/course2/geometry_simulator/src/raytracing/SceneObjects.h", "C++", 109, 0, 0, 0, 6, 30, 145
"/home/plato/mipt_projs/course2/geometry_simulator/src/tests.cpp", "C++", -153, 0, 0, 0, -75, -81, -309
"/home/plato/mipt_projs/course2/geometry_simulator/src/tests.h", "C++", -5, 0, 0, 0, 0, -2, -7
"Total", "-", 1187, 421, 5, -22, 56, 566, 2213